alarm
10
3
1100000011
1011111101
0100000010
0100000010
0100010010
0100110010
0101010010
0100000010
0011111100
0110000110