classroom
10
3
0000000000
1111111111
1000000001
1000110001
1000110001
1001111001
1001111001
1000001101
1111111111
0000000000
