book
10
3
1111111111
1010000001
1010111101
1010000001
1010000001
1010000001
1010000001
1010000111
1010000001
1111111111