computer
10
3
1111111111
1000000001
1000000001
1000000001
1000000001
1000000001
1111111111
0011001100
0011001100
1111111111