10
3
0000000000
1111111111
1000000001
1011111101
1000000001
1011100001
1000001101
1111111111
0000000000
1111111111