아침밥
10
3
0001111000
0011001100
0110000110
0100000010
1111111111
1000000001
1000000001
1100000011
0110000110
0011111100