heart
10
3
0011001100
0100110010
1000000001
1000000001
1000000001
1000000001
0100000010
0010000100
0001001000
0000110000