sun
10
3
0100010001
0010010010
0001111100
0001000100
0111000111
0001000100
0001111100
0010010010
0100010001