pencil
10
3
0011111100
0010000100
0011111100
0010000100
0010000100
0010000100
0011111100
0010000100
0001111000
0000110000