chicken
10
3
1110000000
1001000000
1000111100
0100000010
0010010001
0010000001
0010000101
0010100001
0001000010
0000111100