sns
10
3
0111111110
1100000011
1000000101
1000110001
1001001001
1001001001
1000110001
1000000001
1100000011
0111111110