hamburger
10
3
0111111110
1101001011
1000000001
1111111111
1000000001
1111111111
1111111111
1000000001
1111111111