game
10
3
0111100000
0100111100
1110100110
1010100010
1010100010
1010100010
1010100010
1110111110
0110001100
0011111000