talk
10
3
0011111100
0110000110
1100000011
1000000001
1000000001
1100000011
0110000110
0011011100
0001110000
0011100000