pizza
10
3
0011111100
0110000110
1101111011
1011001101
1010000101
1010000101
1011001101
1101111011
0110000110
0011111100